P00000000000
000000000000
TTT00000000T
000000000000
000000000000
WW0000000000
000000000000
000000000000
BBBBBBBBBBBB
000000000000
000000000000
SSSSSSSSSSSS